BETR	results_cat/betr_betr_eur_pcs.Current_PTSD_Continuous.assoc.gz
COGA	results_cat/coga_coga_eur_pcs.Lifetime_PTSD_Continuous.assoc.gz
COGB	results_cat/cogb_cogb_eur_pcs.Lifetime_PTSD_Continuous.assoc.gz
COM1	results_cat/comc_comc_eur_pcs.Lifetime_PTSD_Continuous.assoc.gz
FSCD	results_cat/fscd_fscd_eur_pcs.Lifetime_PTSD_Continuous.assoc.gz
FTCB	results_cat/ftca_ftca_eur_pcs.Lifetime_PTSD_Continuous.assoc.gz
GMRF	results_cat/gali_gali_eur_pcs.Current_PTSD_Continuous.assoc.gz
GRAC	results_cat/grac_grac_eur_pcs.Lifetime_PTSD_Continuous.assoc.gz
GSDC	results_cat/gsdc_gsdc_eur_pcs.Case.assoc.gz
GTPC	results_cat/gtpc_gtpc_eur_pcs.Current_PTSD_Continuous.assoc.gz
WACH	results_cat/meg2_wach_eur_pcs.Current_PTSD_Continuous.assoc.gz
SATU	results_cat/minv_minv_eur_pcs.Lifetime_PTSD_Continuous.assoc.gz
MRSC	results_cat/mrsc_mrsc_eur_pcs.Current_PTSD_Continuous.assoc.gz
MCVC	results_cat/mrsc_cvc_eur_pcs.Current_PTSD_Continuous.assoc.gz
NGFK	results_cat/nhrv_gfk_eur_pcs.Lifetime_PTSD_Continuous.assoc.gz
VAKN	results_cat/nhrv_vakn_eur_pcs.Lifetime_PTSD_Continuous.assoc.gz
NHS2	results_cat/nhs2_nhs2_eur_pcs.Lifetime_PTSD_Continuous.assoc.gz
NSS1	results_cat/nss1_nss1_eur_pcs.Current_PTSD_Continuous.assoc.gz
PPDS	results_cat/nss1_ppds_eur_pcs.Current_PTSD_Continuous.assoc.gz
NSS2	results_cat/nss2_nss2_eur_pcs.Current_PTSD_Continuous.assoc.gz
ONGA	results_cat/onga_onga_eur_pcs.Lifetime_PTSD_Continuous.assoc.gz
PRIS	results_cat/pris_pris_eur_pcs.Current_PTSD_Continuous.assoc.gz
GUTS	results_cat/psy2_guts_eur_pcs.Lifetime_PTSD_Continuous.assoc.gz
NHSY	results_cat/psy2_nhsy_eur_pcs.Lifetime_PTSD_Continuous.assoc.gz
BRY2	results_cat/psy3_bry2_eur_pcs.Current_PTSD_Continuous.assoc.gz
EACR	results_cat/psy3_eacr_eur_pcs.Current_PTSD_Continuous.assoc.gz
FEEN	results_cat/psy3_feen_eur_pcs.Case.assoc.gz
NCMH	results_cat/psy3_ncmh_eur_pcs.Case.assoc.gz
NIUT	results_cat/psy3_niut_eur_pcs.Current_PTSD_Continuous.assoc.gz
SEEP	results_cat/psy4_psy4_eur_pcs.Case.assoc.gz
BOBA	results_cat/pts1_boba_eur_pcs.Current_PTSD_Continuous.assoc.gz
KMCT	results_cat/pts1_kmct_eur_pcs.Current_PTSD_Continuous.assoc.gz
KSUD	results_cat/pts1_ksud_eur_pcs.Current_PTSD_Continuous.assoc.gz
PORT	results_cat/pts1_port_eur_pcs.Current_PTSD_Continuous.assoc.gz
RING	results_cat/ring_ring_eur_pcs.Current_PTSD_Continuous.assoc.gz
STRO	results_cat/stro_stro_eur_pcs.Case.assoc.gz
YEHU	results_cat/wrby_wrby_eur_pcs.Current_PTSD_Continuous.assoc.gz
BRYA	sumstats/daner_brya_eur_analysis_run3.gz.maf01.gz
DAIP	sumstats/daner_DBS_23.gz.maf01.gz
DAMI	sumstats/daner_psd_25July.gz.maf01.gz
INTR	sumstats/INTr_eur_analysis1_mf.gz.maf01.gz
MIRE	sumstats/MIRE_eur_analysis1_mf.gz.maf01.gz
NCPT	sumstats/N800_eur_analysis1_mf.gz.maf01.gz
QIMR	sumstats/pts_qimr_mix_nm.logscale.results.gz.maf01.gz
UKBB	sumstats/ptsd_qt_ukbb_mar23_2020_unrelated.bgen.stats.gz
VETS	sumstats/ptsd_qt_vetsa_may4_2020_related_filtered.imputed.stats.gz
TRAC	sumstats/TRAC_eur_analysis1_mf.gz.maf01.gz
